%%%%%%%%%%%%%%%%%%%%
%o...%........%...o%
%.%%.%.%%..%%.%.%%.%
%.%..G..%..%.....%.%
%.%.%%.%%  %%.%%.%.%
%...... GG%.%...G..%
%.%....%%%%%%.%..%.%
%.%....%  oo%.%..%.%
%.%....% %%%%.%..%.%
%.%..%........%..%.%
%.%%.%.%%%%%%.%.%%.%
%o...%...P........o%
%%%%%%%%%%%%%%%%%%%%