%%%%%%%%%%%%%%%%%%%..%
%o...%........%...o..%
%.%%.%.%%..%%.%.%%...%
%.%..G..%..%.....%...%
%.%.%%.%%  %%.%%.%...%
%...... G.%.%...G..%.%
%.%....%%%%%%.%..%...%
%.%.G...%  oo%.%..%..%
%.%....% %%%%.%......%
%.%..%........%..%...%
%.%%.%.%%%..%%.%.%...%
%o...%...P........o..%
%%%%%%%%%%%%%%%%%%%..%